20 30 60
1 1 1 1 1 1 1 1 1 1 1 1 1
1 1 1 1 1 0 1 1 1 1 1 1 1
0 0 0 0 0 0 0 0 0 0 0 0 1
1 1 1 1 1 0 1 1 1 1 1 0 1
1 1 1 1 1 0 1 1 1 1 1 0 1
1 1 1 1 1 0 0 0 0 0 0 0 1
1 1 1 1 1 1 1 1 1 1 1 1 1
5 11
2
2 0 2 2 11 0 5 11 0
1 5 3 2 5 20 5 5 0 5 11 0
2
10
0 1 50
0 1 50
0 1 50
0 1 50
0 1 50
0 1 50
0 1 50
0 2 30
0 2 30
0 2 30
10
1 3 1300
0 2 45
0 2 45
0 2 45
0 1 65
0 1 65
0 1 65
0 1 65
0 1 65
0 1 65
